08 08 08 08 08 08 04 05 08 08
08 09 08 00 10 10 01 08 08 00
10 01 08 11 12 12 15 08 09 04
12 15 08 04 03 13 06 10 10 10
03 06 10 10 07 12 12 02 14 14
04 14 14 14 14 14 03 15 08 08
08 08 08 08 08 08 04 05 08 08
08 09 08 00 10 10 01 08 08 00
10 01 08 11 12 12 15 08 09 04
12 15 08 04 03 13 06 10 10 10
03 06 10 10 07 12 12 02 14 14
04 14 14 14 14 14 03 15 08 08
08 08 08 08 08 08 04 05 08 08
08 09 08 00 10 10 01 08 08 00
10 01 08 11 12 12 15 08 09 04
12 15 08 04 03 13 06 10 10 10
03 06 10 10 07 12 12 02 14 14
04 14 14 14 14 14 03 15 08 08
08 08 08 08 08 08 04 05 08 08
08 09 08 00 10 10 01 08 08 00
10 01 08 11 12 12 15 08 09 04
12 15 08 04 03 13 06 10 10 10
03 06 10 10 07 12 12 02 14 14
04 14 14 14 14 14 03 15 08 08
08 08 08 08 08 08 04 05 08 08
08 09 08 00 10 10 01 08 08 00
10 01 08 11 12 12 15 08 09 04
12 15 08 04 03 13 06 10 10 10
03 06 10 10 07 12 12 02 14 14
04 14 14 14 14 14 03 15 08 08
